13  13  13  13  13  13  12  1   1   1   1   1   1   1   5    13   13   13  13  13
13  13  13  13  13  13  4   0   0   0   0   0   0   0   2    13   13   13  13  13
13  13  13  13  13  13  4   0   11  3   3   3   6   0   2    14   44   45  46  47
13  12  1   1   1   1   7   0   2   13  13  13  4   0   2    14   14   14  14  14
13  4   0   0   0   0   0   0   2   13  13  13  4   0   2    14   14   14  14  14
13  4   0   11  3   3   3   3   8   13  13  13  4   0   10   1    1    5   14  14
13  4   0   2   13  13  13  13  13  13  13  13  4   0   0    0    0    2   14  14
13  4   0   2   13  13  13  13  13  13  13  13  9   3   3    6    0    10  1   1
13  4   0   2   13  13  13  13  13  13  13  13  13  13  13   4    0    0   0   51
13  4   50  2   13  40  41  42  43  13  13  13  13  13  13   9    3    3   3   3

