50 50 2  13 4  51 2  13 13  13 13 13 13 13 13 13 14 14 14 14
0  0  2  40 4  0  10 1  1   1  1  1  1  1  1  5  14 14 14 14
0  0  2  41 4  0  0  0  0   0  0  0  0  0  0  2  14 14 14 14
0  0  2  42 9  3  3  3  3   3  3  3  3  6  0  10 1  1  1  5
0  0  2  43 12 1  1  1  1   1  5  16 17 4  0  0  0  0  0  2
0  0  2  13 4  0  0  0  0   0  2  19 18 9  3  3  3  6  0  2
0  0  2  13 4  0  11 3  6   0  10 1  5  40 41 42 43 4  0  2
0  0  10 1  7  0  2  13 4   0  0  0  2  12 1  1  1  7  0  2
0  0  0  0  0  0  2  13 9   3  6  0  10 7  0  0  0  0  0  2
3  3  3  3  3  3  8  13 13  13 4  0  0  0  0  11 3  3  3  8
